EEWWWWWWEE
EWWEEEEWEE
EWDEEEEWEE
WWWWWEEWEE
WEEEWEEWWW
WEEEWEEWEW
WWWWWEEWEW
EWEEEEEWEW
EWEEEEEWWW
EWEEEEAWEE
EWEEEEEWEE