EEWWWWWWEE
EWWEEEEWEE
EWDEEEEWEE
WWWWWWEWEE
WEWWEWEWWW
WEWWEWEWEW
WWWWWWEWEW
EWEEEEEWEW
EWEEEEEWWW
EWEEEEAWEE
EWEEEEEWEE
