EDEWWWWWWWWWWWWWWWWW
EEEEEEEEEEEEEEEEEEEE
WWWWWEWWEEWEWEWEEWEE
EEEWWEWEEEEEEWEWWEEE
WWEWEWWWEWWWWWWWEEEE
EWEEWEWEEWEEEWEWWWEE
EEWEEWWEEWEEWEWWEEWE
EWEWEWWWEEWWEWWEWEEE
WEWEWEWEWWWEWEWEEEEW
EEWWEEWWEEEWEWWEWWWE
WEEEWEEWEWEWEWWEEWEW
EEWEEWEWEEWEEEWWEEEE
EWEEWWWWWWEWEWEEEWWE
WWEEWEWEWEWEWEWEWEEE
EEWWEEWEEWEWEWEEWEWE
WEWWWWWWWWWEEEEEEWEE
EWWEEEWEEEEEEEAEWEEE
EWEEWEWEWEWEWEWWEEEW
EEWEWEWEWEEWEEWEWEWE
WEEEWWWWWEWEWEWWEWEE
